11
11111111111
10000000001
10111000001
10011100001
10000000001
10000000001
10000000011
10010000001
10010000001
10000000001
11111111111
