15
111111111111111
110000000000001
100000000000001
100111110000001
100100010000111
100000000000001
100000000000001
100000000000111
100111110000001
100100010000001
110100010000001
100100010000001
100100010000001
100000000000001
111111111111111
